11111111111111111111111111
1E000000000000C000001C0001
11000101001000001010111101
10100100101010100010010001
1P0000000C00C0000000000001
11111111111111111111111111
