11111111111111111
1E000000P00001111
10100101001000111
10100100101010011
100000000C00C0011
11111111111111111
