11111111111111111111111
1E1000000000000C0000001
10100101001000001010001
1000000C00C000000000001
101000001C10C0000000011
10100101011000001000001
10100101001000001010001
101C1101001000P01000101
11111111111111111111111
