1111111111111111111111111111
1100000000000000000000000001
1E10000001110111010101101011
10000000P00C1000100000000011
1000000000010001000000000001
1001010101010101010101010101
1101010101010101010100100001
1111111111111111111111111111
