1111111111111111111111111111
100E000000000000000000000001
1100000000000000000000000001
1000000000000000001001000001
10P000101010100C100000000001
1111111111111111111111111111
