1111111111111111111111111111
1E000000000000C000001C000001
1100010100100000101011110001
1010010010101010001001000001
1P0000000C00C000000000000001
1111111111111111111111111111
