111111111111111111111111111111
1E1000000000000C00000C00000001
101001010010000010100100000101
1010000C00C0000000000000P00101
101000001C10C000000000000001C1
101001010110000010101000010111
101001010010000010101000010101
101C11010010000010001000010101
111111111111111111111111111111
