1111111111
1E00000001
1001000101
0000010101
10000000C1
1111111111
