111111111111111111111111
101000000000000C0000E011
101001010010000010111111
1000000C00C0000000000011
101001010110000010000011
101001010010111110100011
101C1101001000P010001011
111111111111111111111111
